64 64 64 64 64 64 64 64 64 64 64 64 64 65 64 64 64 64 64 64 64 65 64 64 64 64 64 64 64 64 64 64 64 64 64 65 64 64 64 64 64 64 64 64 64 64 64 64 64 64
64 64 64 65 64 64 64 64 64 64 64 64 64 64 64 64 64 64 64 64 64 64 64 64 64 64 64 64 64 64 65 64 64 64 64 64 64 64 64 64 64 64 64 64 65 64 64 64 64 64
64 64 64 74 72 72 72 72 72 72 72 72 75 64 64 74 72 72 72 72 72 72 72 72 72 72 72 72 72 72 72 72 72 72 72 72 72 72 72 72 72 72 75 64 64 64 64 64 65 64
64 64 64 70 31 31 31 32 31 31 31 31 71 72 72 73 32 31 31 31 31 26 24 24 24 27 31 31 31 31 31 31 31 31 31 31 31 31 31 31 31 31 71 75 64 64 64 64 64 64
64 64 64 70 31 63 63 63 31 31 26 24 27 31 31 31 31 31 26 24 24 25 16 16 16 23 24 24 24 24 27 31 32 31 31 31 31 31 31 31 31 31 31 71 72 72 75 64 64 64
64 64 64 70 31 63 63 31 31 26 25 16 23 27 31 31 31 31 22 49 49 49 49 49 49 49 49 49 49 49 20 31 31 31 31 31 31 63 63 31 32 31 31 31 31 31 69 64 64 64
64 65 64 70 32 31 31 31 26 25 16 49 16 23 27 26 24 24 25 49 37 38 38 38 38 38 38 38 39 49 23 24 27 31 31 31 31 63 63 31 31 31 31 63 31 31 69 64 64 64
64 64 64 70 31 31 31 26 25 16 49 49 49 16 23 25 16 16 49 49 40 34 45 43 43 43 46 36 41 49 49 16 20 31 31 31 31 31 63 63 63 63 63 63 31 31 69 64 64 64
64 64 64 76 68 31 26 25 16 49 49 49 49 49 16 16 49 49 49 49 40 36 41 16 16 16 40 34 41 49 49 16 23 27 31 31 32 31 63 63 63 63 63 63 31 31 69 65 64 64
64 64 64 64 70 26 25 16 49 49 49 49 49 49 49 49 49 49 49 49 40 34 41 16 30 16 40 34 41 49 49 49 16 23 27 31 31 31 31 63 63 63 63 63 31 31 69 64 64 64
64 64 64 64 70 22 16 49 49 49 49 49 49 49 49 49 16 16 49 49 40 36 41 16 16 16 40 34 41 49 49 49 49 16 20 31 31 31 31 63 31 31 63 63 31 31 69 64 64 64
64 64 64 64 70 28 19 16 49 49 49 49 49 49 49 49 49 49 49 49 40 34 47 38 10 38 48 34 41 49 49 49 49 16 20 31 31 31 31 31 32 31 31 31 31 31 69 64 64 64
64 64 64 64 70 31 28 19 16 49 49 49 49 49 16 16 49 49 49 49 42 43 43 43 11 43 43 43 44 49 49 16 49 49 23 24 27 31 31 31 31 31 31 31 31 31 69 64 64 64
64 64 64 64 70 31 31 28 19 16 49 49 49 16 17 19 16 49 49 49 49 49 49 16 16 16 49 49 49 49 16 16 49 49 49 16 23 27 31 31 31 63 31 63 31 66 77 64 64 64
64 64 64 64 70 31 31 31 28 19 16 49 16 17 29 28 19 16 49 49 16 16 16 16 16 16 16 16 16 16 17 19 16 49 49 49 16 23 27 31 31 31 63 63 31 69 64 64 64 64
64 64 64 64 70 31 31 31 31 28 19 16 17 29 31 31 28 19 16 16 17 18 19 16 16 16 16 16 17 18 29 28 19 16 49 49 49 16 23 27 31 31 31 31 31 69 64 64 64 64
64 64 64 64 70 31 32 31 31 31 28 18 29 31 31 31 31 28 18 18 29 31 28 18 18 18 18 18 29 31 31 31 28 19 16 49 49 49 16 23 27 31 31 31 31 69 64 64 64 65
65 64 74 72 73 31 31 31 31 31 31 31 31 31 32 31 31 31 31 31 31 31 31 31 31 31 32 31 31 31 31 31 31 22 16 49 49 49 49 16 20 31 32 31 31 69 64 64 64 64
64 64 70 31 31 31 31 31 31 31 31 63 31 31 31 63 31 31 31 63 63 63 31 31 31 31 31 31 31 31 31 31 32 28 19 16 16 49 49 16 23 27 31 31 31 69 64 64 64 64
64 64 70 31 31 63 63 31 31 31 31 63 63 31 63 63 63 31 31 31 63 63 31 59 57 60 31 31 63 63 63 31 31 31 28 18 19 16 49 49 16 23 27 31 31 69 64 64 64 64
64 64 70 31 31 63 63 63 31 32 31 63 63 63 63 63 63 63 31 31 31 31 31 55 50 54 31 31 63 63 63 63 31 31 31 32 22 16 49 49 49 16 20 31 32 69 64 64 64 64
64 64 70 31 31 63 63 63 31 31 31 31 63 63 63 63 63 63 63 31 31 32 31 55 50 54 31 32 63 63 63 63 31 31 31 31 28 19 16 49 49 16 20 31 31 69 64 64 64 64
64 64 70 31 31 63 63 63 31 31 31 32 31 31 63 63 63 63 63 63 63 31 31 55 50 54 31 31 63 63 63 63 31 32 31 31 26 25 16 49 49 16 23 27 31 69 64 64 64 64
64 64 70 31 31 63 63 63 63 63 31 31 31 31 31 31 32 31 31 31 31 31 31 55 50 54 31 31 31 31 31 31 31 31 31 26 25 16 49 49 49 49 16 20 31 69 64 64 64 64
64 64 70 31 31 63 63 63 63 63 63 31 59 57 57 57 57 57 57 57 57 57 57 58 50 56 57 57 57 57 57 57 57 57 60 22 16 49 49 49 49 49 49 23 27 69 64 65 64 64
64 64 70 31 31 63 63 63 63 33 31 31 55 50 50 50 50 50 50 50 50 50 50 50 50 50 50 50 50 50 50 50 50 50 54 22 16 16 15 49 49 49 49 16 20 69 64 64 64 64
64 64 70 31 31 63 63 63 63 63 63 31 61 52 52 52 52 52 52 52 52 52 52 53 50 51 52 52 52 52 52 52 52 52 62 22 16 49 49 49 49 49 49 17 29 69 64 64 64 64
64 64 70 31 31 63 63 63 63 63 63 31 32 31 31 31 31 31 31 31 32 31 31 55 50 54 31 31 31 31 31 31 31 31 31 28 19 16 49 49 49 49 16 20 31 69 64 64 64 64
64 64 70 31 31 63 31 31 32 31 63 63 31 31 63 63 63 63 63 63 63 31 31 55 50 54 32 31 31 63 31 31 31 31 31 31 28 19 16 49 49 16 17 29 31 69 64 64 64 64
64 64 70 31 31 63 31 31 31 31 31 63 63 63 63 63 63 63 63 31 63 63 32 55 50 54 31 31 63 63 63 63 31 32 31 63 31 28 19 16 16 17 29 31 31 71 75 64 64 64
64 64 70 31 31 63 31 66 67 68 31 63 63 63 63 63 31 63 31 31 31 63 31 55 50 54 31 31 63 63 63 63 31 31 31 63 63 31 28 18 18 29 31 31 31 31 69 64 64 64
64 64 70 31 31 63 31 69 64 70 31 31 31 31 31 31 31 63 63 31 63 63 31 55 50 54 31 31 31 63 63 31 31 31 31 31 31 31 31 31 31 32 31 31 31 31 69 64 64 64
64 64 70 31 31 63 31 69 65 76 67 67 67 67 67 68 31 31 63 63 63 63 31 55 50 54 31 31 31 63 63 63 63 63 31 31 32 31 31 31 31 31 31 63 63 31 69 64 64 64
65 64 76 68 31 63 31 69 64 64 64 64 64 64 65 76 68 31 31 32 31 63 31 55 50 54 31 31 32 63 63 63 63 63 63 63 31 31 31 31 63 63 63 63 63 31 69 64 65 64
64 64 64 70 31 63 31 69 64 64 65 64 64 64 64 64 76 67 67 68 31 63 31 55 50 54 31 31 31 63 63 63 63 63 63 63 63 63 63 63 63 63 63 63 31 31 69 64 64 64
64 64 64 70 31 63 31 69 74 72 72 72 72 72 72 72 72 72 72 73 31 63 31 55 50 54 31 31 63 63 63 63 63 63 63 63 63 63 63 63 63 63 63 63 31 31 69 64 64 64
64 64 64 70 31 63 31 71 73 31 31 32 31 31 31 31 31 31 31 31 31 31 31 55 50 54 31 31 63 63 63 63 63 63 63 63 63 63 63 63 63 63 63 63 31 31 69 64 64 64
64 64 64 70 31 63 31 31 31 31 31 63 63 63 63 63 63 63 63 63 63 31 31 55 50 54 31 31 63 63 63 63 63 63 63 63 63 63 63 63 63 63 63 63 31 31 69 64 64 64
64 64 64 70 31 63 63 63 63 63 63 63 63 63 63 63 63 63 63 63 63 63 31 55 50 54 31 32 63 63 63 63 63 63 63 63 31 31 31 31 31 31 63 63 63 31 69 64 64 64
64 64 64 70 31 31 63 63 63 63 63 31 31 31 31 31 31 31 63 63 63 31 31 55 50 54 31 31 31 63 63 63 63 63 63 31 31 31 31 31 31 31 31 63 63 31 69 64 64 64
64 64 64 70 31 31 32 31 31 31 31 31 31 32 31 31 31 31 31 31 31 32 31 55 50 54 31 31 31 31 31 31 31 31 31 31 66 67 67 67 67 68 31 63 63 31 69 64 65 64
64 64 64 70 31 31 31 31 31 31 31 31 66 67 67 67 67 67 68 31 31 31 31 61 52 62 31 31 31 66 67 67 67 68 31 31 69 64 64 64 64 70 31 31 31 31 69 64 64 64
64 64 64 76 67 67 67 67 67 67 67 67 77 64 64 64 64 64 76 67 67 67 67 67 12 67 67 67 67 77 64 64 64 76 67 67 77 64 64 64 64 76 67 67 67 67 77 64 64 64
64 64 64 64 64 64 64 64 64 64 64 64 64 64 64 64 64 64 64 64 64 64 74 72 13 72 75 64 64 64 64 64 64 64 64 64 64 64 64 64 64 64 64 64 64 64 64 64 64 64
64 64 64 64 64 64 64 64 65 64 64 64 64 64 64 64 64 64 64 64 64 64 70 31 31 31 69 64 64 64 64 64 64 64 64 64 64 64 64 65 64 64 64 64 64 64 64 64 64 64
64 64 64 64 64 64 64 64 64 64 64 64 64 64 64 64 64 64 64 64 64 64 70 31 14 31 69 64 64 64 64 64 64 65 64 64 64 64 64 64 64 64 64 64 64 64 64 64 64 64
64 64 65 64 64 64 64 64 64 64 64 64 64 64 64 64 64 65 64 64 64 64 70 31 31 31 69 64 64 64 64 64 64 64 64 64 64 64 64 64 64 64 64 64 65 64 64 64 64 64
64 64 64 64 64 64 64 64 64 64 64 64 64 64 64 64 64 64 64 64 64 64 76 67 67 67 77 64 64 65 64 64 64 64 64 64 64 64 64 64 64 64 64 64 64 64 64 64 64 64
64 64 64 64 64 64 64 64 64 64 64 65 64 64 64 64 64 64 64 64 64 64 64 64 64 64 64 64 64 64 64 64 64 64 64 64 64 64 64 64 64 64 64 64 64 64 64 64 64 64
64 64 64 64 64 64 64 64 64 64 64 64 64 64 64 64 64 64 64 64 64 64 64 65 64 64 64 64 64 64 64 64 64 64 64 64 64 64 65 64 64 64 64 64 64 64 64 64 64 64